WWWWWW00WWWWWW
WWWWWW00WWWWWW
WWWW0000WWWWWW
WWWW00W00D0K0W
WWW0000E0WW00W
WWWE00000WWX0W
WW000000X0000W
WWWWWX0WWWWWWW
WWWWW000X0000W
WWWWW0X000X00W
WWWWWWWWWWW0XW
WA000X000X000W
WAPX000X000X0W
WWWWWWWWWWWWWW
