WWWWWWWWWWWWWW
W0000000000GWW
W0WWWWW0WWW0WW
W0WW00W00W000W
W00000000WW00W
WW00WWWW0WW00W
WWEW000000000W
WW0WW00WWWWWWW
W000W00W00000W
W0W0W0000W000W
W0W0WWWW0WWW0W
W0WWWWWW00WW0W
W000000000000W
WWWWWW0WWWWWWW